1 1 1 1
1 1 0 1
1 v 0 1
1 1 g 1
1 1 1 1

1 1 1 1
1 1 g 1
1 v 0 1
1 1 0 1
1 1 1 1
