1 1 1 1 1 1
1 1 1 0 ^ 1
1 0 0 0 0 1
1 0 g x 0 1
1 0 0 0 0 1
1 1 1 1 1 1

1 1 1 1 1 1
1 1 1 0 0 1
1 < 0 0 g 1
1 0 x 0 0 1
1 0 0 0 0 1
1 1 1 1 1 1