1 1 1 1 1 1
1 0 0 0 v 1
1 0 0 0 0 1
1 g 0 0 x 1
1 0 0 0 0 1
1 1 1 1 1 1

1 1 1 1 1 1
1 0 0 0 0 1
1 ^ 0 x 0 1
1 0 0 0 0 1
1 0 0 g 0 1
1 1 1 1 1 1